#####B#
####  #
###  ##
#### ##
     ##
#A#####
